Jahr	Total Verunfallte	Total Schwerverletzte	Total Leichtverletzte	mit Personenschaden	mit Sachschaden	Total Unfälle	Total Getötete
2006	659	129	528	572	1264	1836	2
2007	603	118	482	529	1217	1746	3
2008	589	98	485	495	969	1464	6
2009	567	107	456	472	878	1350	4
2010	462	96	362	381	772	1153	4
2011	391	90	298	317	631	948	3
2012	307	81	221	256	642	898	5
2013	399	82	315	327	702	1029	2
2014	437	88	347	374	732	1106	2
2015	473	97	373	391	735	1126	3
